!,+,+,+,+,+,
A,N,X,I,O,U,
@,@,E,T,J,S,
L,O,N,I,D,?,
?,U,@,@,?,?,
*,T,E,S,*,T,
?,O,@,G,@,@,
I,N,*,H,C,L,
U,Q,@,@,O,D,
?,S,H,O,U,T,
@,@,L,L,T,?,
E,W,O,?,C,?,