!,+,+,+,+,+,+,
W,E,L,C,O,M,E,
*,T,O,*,*,*,*,
*,S,N,O,W,*,*,
@,W,O,R,L,D,@,