@,+,+,!,+,+,@,
D,O,G,C,U,T,E,
?,?,?,*,?,?,?,
@,@,?,*,?,@,@,
R,D,X,E,N,T,E,
?,H,@,@,@,A,?,
?,E,O,*,X,L,K,
?,R,O,M,E,L,E,