+,+,!,*,+,+,+,
H,E,L,L,O,*,+,
P,L,E,A,S,*,+,
E,N,J,O,*,*,+,
T,H,E,G,A,M,E,