!,+,+,+,
L,I,F,E,
*,I,S,*,
N,O,T,@,
F,A,I,R,
G,E,T,*,
U,S,E,D,
T,O,I,T,