-,?,?,?,-,
R,A,#,E,C,
G,*,D,$,O,
B,O,A,R,D,
R,E,N,I,D,