*,*,+,!,+,*,*,
E,P,O,B,S,I,T,
K,D,S,M,A,R,E,
@,@,@,S,@,@,@,
R,A,U,I,N,O,N,
N,G,E,C,A,T,I,