+,+,+,!,+,
V,O,I,C,E,
@,C,*,O,I,
?,A,O,D,N,
C,K,E,E,P,