+,+,+,+,!,
O,L,V,E,I,
S,A,N,@,@,
N,R,T,I,*,
@,@,H,E,N,
*,R,R,G,A,
?,A,O,W,?,
O,V,@,N,?,
?,E,*,C,E,
?,?,?,?,?,
?,?,?,?,?,
?,?,?,?,?,