+,+,+,!,+,+,+,
B,E,D,I,S,T,E,
?,N,@,@,@,N,*,
?,D,I,*,R,O,Y,
K,D,S,M,A,R,O,
@,@,@,O,@,@,@,
*,N,I,V,L,O,T,
P,X,E,E,E,N,I,
?,?,?,?,?,?,?,