N,I,O,N,A,
O,T,I,N,L,
I,A,*,T,A,
T,N,R,E,P,
A,C,I,L,P,