!,+,+,+,+,+,
?,?,?,?,?,?,
?,@,@,?,?,?,
*,?,?,?,?,?,
?,?,?,?,?,?,
?,?,?,@,@,?,
?,?,?,?,?,?,
?,?,?,?,?,?,
?,?,@,@,?,?,
?,?,*,?,?,?,
?,?,?,?,?,?,
@,?,@,?,@,?,
?,?,?,?,?,?,
?,?,?,*,?,?,
?,@,?,@,?,@,
?,?,?,?,?,?,
?,?,?,?,?,?,
?,?,?,?,?,?,