!,+,+,+,+,+,
?,?,?,?,?,?,
?,?,*,?,?,?,
?,?,?,?,?,?,
?,?,?,?,?,?,
?,?,?,?,*,?,
?,?,?,?,?,?,
?,?,*,?,?,?,
?,?,?,?,?,?,
?,?,?,?,?,?,