+,+,+,!,+,+,+,
L,O,V,E,@,I,S,
L,I,K,E,*,A,*,
F,L,O,W,E,R,@,
Y,O,U,H,A,V,E,
G,O,T,@,T,O,@,
L,E,T,@,I,T,@,
G,R,O,W,@,@,@,
B,Y,*,J,O,H,N,
L,E,N,N,O,N,@,