-,?,?,?,-,
?,?,#,?,?,
?,*,?,$,?,
?,?,?,?,?,
?,?,?,?,?,