!,+,+,+,+,+,
@,?,?,?,?,?,
?,@,?,?,?,?,
?,?,@,?,?,?,
?,?,*,@,?,?,
?,?,E,*,@,?,
?,?,?,?,*,?,
?,?,?,?,?,?,