@,@,!,@,@,
E,E,E,E,E,
C,W,I,T,H,
A,D,G,A,A,
P,R,T,M,V,