-,*,#,$,-,
T,R,M,E,R,
B,Y,I,C,T,
*,A,#,K,$,
P,R,O,O,F,
I,D,L,V,E,