-,*,#,$,-,
P,O,L,C,E,
T,C,I,E,?,
*,O,N,N,$,
A,C,T,O,R,
R,E,P,L,Y,