!,+,+,+,+,+,+,
C,H,A,T,T,E,R,
R,D,X,@,N,T,E,
?,H,*,E,*,A,?,
?,E,O,I,X,L,K,
?,R,O,M,E,L,E,