+,+,+,!,+,+,+,
L,O,O,K,E,Y,+,
H,A,M,M,E,R,+,
B,U,T,T,O,N,*,
A,D,D,W,O,R,D,