!,+,+,+,+,
M,T,A,E,?,
?,O,G,?,J,
?,S,X,I,D,
@,@,Y,@,@,
*,U,O,N,*,
?,T,@,G,I,
E,S,*,H,O,
U,Q,P,L,N,
?,?,?,?,?,
?,?,?,?,?,