!,+,+,+,+,+,+,
@,@,@,@,@,+,@,
*,*,+,*,*,*,*,
W,E,L,C,O,M,E,
T,O,C,L,O,U,D,
V,I,L,L,A,G,E,