-,-,*,#,$,-,-,
P,L,A,Y,E,R,-,
U,N,K,N,O,W,N,
B,A,T,T,L,E,#,
G,R,O,U,N,D,S,