+,+,+,+,+,+,!,
W,I,T,H,O,U,T,
@,*,@,@,@,@,@,
@,H,A,S,T,E,*,
@,B,U,T,@,@,*,
W,I,T,H,O,U,T,
@,R,E,S,T,@,@,