!,+,+,G,O,O,D,
@,@,@,@,@,@,*,
M,O,R,N,I,N,G,
E,V,E,R,Y,*,@,
O,N,E,@,@,@,@,