!,+,+,+,+,+,+,
?,?,?,?,?,?,?,
?,@,?,@,?,@,?,
?,?,?,*,?,?,?,
@,?,@,?,@,?,@,
?,?,?,?,?,?,?
?,@,?,@,?,@,?,
?,?,?,*,?,?,?,
@,?,@,?,@,?,@,
?,?,?,?,?,?,?
?,@,?,@,?,@,?,
?,?,?,?,?,?,?,
@,?,@,?,@,?,@,
?,?,?,?,?,?,?,