!,+,+,+,+,
G,F,F,I,C,
O,O,S,E,?,
V,X,E,E,T,
E,N,A,*,?,
R,A,P,L,E,
N,M,E,N,T,
E,H,*,R,?,
S,@,@,@,O,
S,?,?,?,*,
S,A,M,E,O,