+,+,+,!,+,+,+,
I,T,I,S,N,O,T,
L,E,N,G,T,H,*,
O,F,*,L,I,F,E,
B,U,T,@,@,@,@,
D,E,P,T,H,*,*,
O,F,@,L,I,F,E,