-,*,#,$,-,
V,O,I,C,E,
?,C,F,O,I,
?,A,O,D,N,
C,K,E,E,P,