!,+,+,+,+,+,+,
?,?,?,?,?,?,?,
?,?,?,?,*,?,?,
?,@,@,@,?,@,@,
?,?,?,?,?,?,?,
?,?,?,?,?,?,?,
@,@,*,?,@,@,@,
?,?,?,?,?,?,?,
?,@,?,@,?,@,?,
?,?,?,?,?,?,?,
@,?,@,*,@,?,@,
?,?,?,?,?,?,?,
?,?,?,?,?,?,?,
?,?,@,@,@,?,?,
?,?,?,?,?,?,?,
@,?,@,?,@,?,@,
?,?,?,*,?,?,?,
?,@,?,?,?,@,?,
?,?,?,?,?,?,?,
?,?,?,?,?,?,?,
?,@,@,@,?,?,@,
?,?,?,?,?,?,?,
?,?,?,?,?,?,?,
?,?,?,?,?,?,?,