+,+,+,!,+,+,+,
T,S,I,T,N,E,D,
@,@,O,O,?,N,?,
?,L,A,T,?,I,?,
?,I,@,@,@,G,H,
?,K,E,*,L,Y,T,
D,A,I,C,E,@,@,
?,?,*,?,N,?,?,
?,?,?,?,D,?,?,