+,+,!,+,+,
O,F,F,I,C,
P,O,S,E,*,
E,X,*,C,T,
R,N,M,A,?,
O,A,*,N,E,
T,I,O,L,?,
E,H,U,R,?,