!,+,+,+,+,+,
T,H,I,N,K,?,
?,?,?,*,?,?,
*,R,I,C,H,?,
?,?,?,?,?,*,
?,L,O,O,K,?,
P,O,O,R,?,?,