!,+,+,+,+,
@,M,O,N,@,
M,D,*,T,A,
C,E,Y,S,E,
@,*,P,*,@,
T,E,E,T,H,
R,O,I,N,T,