!,+,+,+,+,+,+,
?,?,?,?,?,?,?,
?,?,?,?,*,?,?,
?,@,@,@,?,@,@,
?,?,?,?,?,?,?,
?,?,?,?,?,?,?,
?,@,*,?,@,@,@,
?,?,?,?,?,?,?,
?,@,?,@,?,@,?,
?,?,?,?,?,?,?,
?,?,@,*,@,?,@,
?,?,?,?,?,?,?,
?,?,?,?,?,?,?,
?,?,@,@,@,?,?,
?,?,?,?,?,?,?,
?,?,@,?,@,?,@,
?,?,?,*,?,?,?,
?,@,?,?,?,@,?,
?,?,?,?,?,?,?,
?,?,?,?,?,?,?,
?,@,@,@,?,?,@,
?,?,?,?,?,?,?,
?,?,?,?,?,?,?,
?,?,?,?,?,?,?,