+,+,!,+,+,
J,E,C,E,N,
O,H,*,D,?,
U,R,I,Z,O,
R,T,E,N,?,
N,L,G,T,*,
E,I,A,H,?,
*,S,W,N,?,
K,C,U,L,?,