$,-,-,-,#,
N,O,C,T,N,
G,O,I,T,A,
R,N,*,A,R,
A,T,U,L,U,
R,E,S,T,A,