!,+,+,+,+,+,
A,R,R,A,N,G,
?,?,I,@,@,E,
@,@,G,*,S,N,
L,O,H,O,E,U,
L,V,T,?,@,@,
N,E,L,E,V,E,
*,@,@,?,I,A,
V,E,L,?,C,T,
E,M,@,@,T,?,
R,B,I,C,O,*,
@,L,E,A,R,@,
?,?,?,?,Y,?,