+,+,+,!,+,+,+,
L,O,V,E,*,I,S,
S,O,M,E,T,H,I,
N,G,@,@,@,@,@,
T,H,E,@,@,@,@,
A,S,P,E,C,T,@,
M,A,Y,*,*,*,*,
C,H,A,N,G,E,*,
B,U,T,*,N,O,T,
T,H,E,*,*,*,*,
E,S,S,E,N,C,E,