!,+,+,+,+,
H,E,L,L,O,
T,H,A,N,K,
P,*,*,*,Q,
H,A,V,E,A,
G,O,O,D,J,
A,T,I,M,E,