!,+,+,+,
?,?,?,?,
?,?,?,?,
?,?,?,?,
?,?,?,?,
?,?,?,?,
*,?,?,?,
?,*,?,?,
?,?,*,?,
?,?,?,?,