!,+,+,+,+,+,
W,I,T,H,V,E,
C,A,@,L,O,N,
?,N,*,V,I,E,
W,I,T,H,?,V,
Z,?,O,?,@,E,
?,J,U,?,*,N,
H,A,P,P,I,E,
?,X,@,E,C,S,
O,B,*,A,E,S,
?,?,?,?,?,?,
?,?,?,?,?,?,