!,T,H,A,N,K,*,
@,@,@,@,@,@,*,
*,*,Y,O,U,*,*,
*,@,@,@,@,@,@,
*,*,F,O,R,*,*,
@,@,@,@,@,@,*,
P,L,A,Y,I,N,G,