!,+,+,+,+,
A,I,U,E,O,
*,*,*,*,*,
B,C,D,F,G,
*,*,*,*,*,
H,J,K,L,M,
*,*,*,*,*,
A,I,U,E,O,