!,+,+,+,+,+,+,
I,F,@,@,@,@,@,
Y,O,U,*,C,A,N,
D,R,E,A,M,I,T,
*,*,*,*,*,*,*,
Y,O,U,@,C,A,N,
D,O,*,I,T,@,@,
B,Y,*,W,A,L,T,
D,I,S,N,E,Y,@,