$,$,-,#,-,*,*,
F,O,R,E,I,G,N,
?,?,?,?,?,?,?,
*,*,#,A,#,$,T,
I,M,P,O,R,T,A,
?,?,?,?,?,?,N,