-,*,-,#,-,$,-,
A,N,I,M,A,L,N,
P,C,O,E,N,P,E,
H,E,R,S,L,A,X,
C,A,K,E,Y,G,U,