!,+,+,+,+,+,
P,E,A,C,E,*,
B,E,G,I,N,S,
W,I,T,H,*,A,
S,M,I,L,E,@,