!,+,+,+,*,
O,F,F,I,C,
P,O,S,E,?,
E,X,A,C,T,
R,N,M,S,?,
A,A,P,L,E,
T,I,O,N,?,
E,H,U,R,?,