!,+,+,+,+,
@,S,E,X,@,
T,O,*,G,H,
G,N,*,I,*,
T,E,E,R,H,
B,O,Y,L,A,