!,+,+,+,+,+,+,
A,N,I,M,A,L,N,
T,I,G,R,A,B,I,
E,P,?,*,?,?,?,
P,E,O,E,N,P,E,
H,*,R,S,L,*,X,
C,A,K,E,Y,G,U,