+,+,!,+,+,
O,F,F,I,C,
P,O,S,E,*,
E,X,*,C,T,
R,N,M,S,?,
A,A,*,L,E,
T,I,O,N,?,
E,H,U,R,?,