-,R,?,Y,-,
*,A,#,L,$,
?,R,E,?,T,
S,A,G,F,Y,
L,T,I,S,O,
B,S,U,M,I,