!,+,+,+,+,+,
I,S,L,O,V,E,
A,N,*,A,R,T,
T,H,E,?,?,I,
?,?,N,?,?,S,
?,A,D,N,*,E,
R,E,Q,U,I,R,
?,?,*,?,?,?,
E,F,F,O,R,T,
?,?,?,?,?,?,