!,+,+,+,+,+,+,
?,?,?,?,?,?,?,
?,?,?,?,?,?,?,
?,?,?,?,?,?,?,
*,@,*,@,*,@,*,
*,@,*,@,*,@,*,
*,@,*,@,*,@,*,
*,@,*,@,*,@,*,
?,?,?,?,?,?,?,
?,?,?,?,?,?,?,
?,?,?,?,?,?,?,
@,*,@,*,@,*,@,
@,*,@,*,@,*,@,
@,*,@,*,@,*,@,
@,*,@,*,@,*,@,
?,?,?,?,?,?,?,
?,?,?,?,?,?,?,
?,?,?,?,?,?,?,
@,+,@,+,@,+,@,
@,+,@,+,@,+,@,
@,+,@,+,@,+,@,
@,+,@,+,@,+,@,