!,+,+,+,+,
G,F,F,I,C,
O,O,S,E,?,
E,N,A,*,?,
R,A,P,L,E,
E,H,*,R,?,
S,@,@,@,O,
S,?,?,?,*,
S,A,M,E,O,