+,+,+,+,!,
?,?,?,?,?,
?,?,?,?,*,
?,?,?,?,?,
?,?,?,?,?,
*,?,?,?,?,
?,?,?,?,?,
?,?,*,?,?,
?,?,?,?,?,