!,+,+,+,+,+,+,
@,@,@,@,@,+,@,
*,*,+,*,*,*,*,
W,E,L,C,O,M,E,
T,O,*,S,N,O,W,
V,I,L,L,A,G,E,