!,U,X,U,+,
T,R,*,T,H,
S,P,L,I,T,
@,*,O,*,@,
L,E,V,E,L,
A,N,E,G,T,