!,+,+,+,+,+,+,
N,O,@,D,O,G,@,
*,*,*,*,*,*,*,
N,O,@,L,I,F,E,
P,A,N,D,A,@,@,
A,N,D,@,D,O,G,