+,+,+,+,!,
O,F,E,F,R,
W,I,?,?,*,
N,O,T,I,C,
?,E,C,?,E,
*,R,S,S,A,
?,I,P,Y,?,
O,S,*,A,?,
?,T,?,C,E,