+,+,+,!,+,+,+,
C,A,U,S,E,P,E,
O,*,G,E,C,T,X,
V,?,?,S,*,?,A,
E,?,@,@,@,A,C,
R,?,?,*,?,?,T,
?,?,?,?,?,?,?,