-,-,*,#,$,-,-,
D,R,A,G,O,N,#,
*,*,*,B,A,L,L,
A,K,I,R,A,$,T,
O,R,I,Y,A,M,A,