@,@,@,!,@,@,
H,A,M,M,E,R,
B,U,T,T,O,N,
B,R,E,A,K,*,
T,H,E,B,O,X,