!,+,+,+,+,+,+,
W,E,?,L,O,V,E,
I,T,H,O,G,U,T,
T,@,S,@,G,@,*,
E,@,E,@,I,@,*,
A,@,E,@,R,@,*,
M,@,D,@,L,@,*,
E,S,S,?,E,O,N,
?,?,O,Y,U,X,?,
?,?,?,?,?,?,?,