+,+,+,!,+,+,+,
A,C,C,O,U,T,N,
?,?,@,@,@,N,*,
?,?,?,?,?,Y,?,
P,R,O,*,D,I,G,
K,D,S,M,A,R,O,
@,@,@,S,@,@,@,
*,D,R,I,V,O,E,
P,X,E,C,E,T,I,