*,-,-,-,-,
?,#,-,-,-,
?,?,$,-,-,
?,?,?,#,-,
?,?,?,?,*,
?,?,?,?,?,