!,+,+,+,+,+,
C,A,N,Y,O,U,
P,L,E,A,S,E,
*,*,*,*,*,*,
W,R,I,T,E,A,
*,*,*,*,*,*,
R,E,V,I,E,W,