!,+,+,+,+,+,+,
?,?,?,?,?,?,?,
?,@,?,@,?,@,?,
?,?,?,?,?,?,?,
@,?,@,*,@,?,@,
?,?,?,?,?,?,?,
?,@,?,@,?,@,?,
?,?,?,?,?,?,?,
@,?,@,?,@,?,@,
?,?,?,?,?,?,?,
*,@,?,@,?,@,*,
?,?,?,?,?,?,?,
@,?,@,?,@,?,@,
?,?,?,?,?,?,?,
?,@,?,@,?,@,?,
?,?,?,?,?,?,?,
@,?,@,*,@,?,@,
?,?,?,?,?,?,?,
?,@,?,@,?,@,?,
?,?,?,?,?,?,?,
@,?,@,?,@,?,@,
?,?,?,?,?,?,?,
@,?,@,?,@,?,@,
?,?,?,?,?,?,?,