!,+,+,+,+,+,
C,H,A,N,C,E,
?,?,?,?,A,*,
?,?,@,@,L,?,
?,?,*,O,L,?,
@,@,E,V,@,@,
?,?,?,?,*,?,
?,?,?,?,?,?,