+,+,+,+,+,+,!,
W,I,T,H,O,U,T,
@,*,@,@,@,@,@,
@,H,A,S,T,E,*,
@,@,@,@,@,@,*,
W,I,T,H,O,U,T,
@,R,E,S,T,@,@,