+,+,!,+,+,
@,@,E,@,@,
@,A,O,L,@,
*,R,@,N,*,
S,A,G,F,Y,
L,T,I,S,O,
B,S,U,M,I,
G,A,M,O,A,