+,+,+,+,!,
*,@,@,@,@,
D,R,I,V,E,
@,C,*,O,I,
*,A,O,D,N,
C,R,E,E,P,