+,+,+,+,+,+,!,
*,@,@,?,@,@,@,
W,E,L,C,O,M,E,
H,A,P,Y,N,P,E,
G,E,T,*,U,P,X,
C,A,@,@,@,@,@,
C,H,E,E,R,U,P,
@,@,@,O,@,@,*,