+,+,+,!,+,+,+,
?,?,?,?,?,?,?,
@,@,*,*,*,*,*,
?,?,*,?,?,?,?,
?,?,@,@,@,?,?,
?,?,?,?,?,*,?,
?,?,?,?,?,@,@,
?,?,*,?,?,?,?,
?,?,?,?,?,?,?,