!,+,+,I,+,
O,F,F,@,C,
P,O,S,E,?,
E,X,E,E,T,
R,N,A,S,?,
A,A,P,L,E,
T,I,O,N,?,
E,H,U,R,?,
S,@,@,@,O,
S,A,M,E,O,
S,A,M,E,O,