!,+,+,+,+,
@,O,W,N,@,
M,R,*,T,A,
C,L,O,S,E,
@,*,P,*,@,
T,E,E,T,H,
R,O,I,N,T,