!,+,+,+,*,+,+,
@,@,@,@,F,@,+,
@,@,@,@,A,@,+,
@,@,@,@,L,@,+,
@,@,@,@,L,@,+,
@,@,@,@,H,@,+,
@,@,@,@,O,@,+,
@,@,@,@,L,@,+,
@,@,@,@,E,@,+,
@,@,@,@,*,@,+,
?,?,?,?,?,?,?,
?,?,?,?,?,?,?,
?,?,?,?,?,?,?,
?,?,?,?,?,?,?,
?,?,?,?,*,?,?,