+,+,+,!,+,+,+,
C,A,U,S,E,P,X,
?,*,?,?,C,T,?,
?,?,?,?,*,?,?,
?,?,@,@,@,A,?,
?,?,?,*,?,?,?,
?,?,?,?,?,?,?,