!,+,+,+,+,+,
?,?,?,?,?,?,
@,@,@,?,?,?,
?,*,?,?,?,?,
?,?,?,?,?,?,
?,@,?,@,?,@,
?,?,?,?,?,?,
?,?,?,?,?,?,
?,?,?,@,@,@,
?,?,?,?,?,?,
?,?,?,?,*,?,
@,?,@,?,@,?,
?,?,?,?,?,?,
?,?,?,?,?,?,
?,?,@,@,?,?,
?,?,?,?,?,?,
?,?,*,?,?,?,
?,?,?,?,?,?,
@,@,?,?,@,@,
?,?,?,?,?,?,
?,?,?,?,?,?,
?,?,?,?,?,?,