!,+,+,+,+,+,
@,@,@,@,@,*,
+,+,+,+,+,+,
A,B,R,O,A,D,,
*,E,O,S,L,?,
A,C,T,O,?,*,
T,A,S,E,T,?,