!,+,+,+,+,
?,?,+,?,?,
?,?,+,?,?,
?,?,+,?,?,
@,@,+,@,@,
*,@,+,@,*,
?,+,@,+,?,
?,+,*,+,?,
?,?,?,?,?,
?,?,?,?,?,
?,?,?,?,?,