!,+,+,+,+,
@,O,W,N,@,
T,R,*,T,H,
C,L,O,S,E,
@,*,P,*,@,
T,E,E,T,H,
R,O,H,N,T,