?,?,?,?,*,
?,?,?,#,O,
?,?,$,E,?,
?,#,U,?,?,
*,I,?,?,?,
A,?,?,?,?,