!,+,+,+,+,+,+,
?,?,?,?,?,?,?,
?,?,?,?,?,?,?,
?,@,@,@,?,?,?,
?,?,*,?,?,?,?,
?,?,?,?,?,?,?,
?,?,?,?,@,@,@,
?,?,?,?,?,?,?,
?,@,?,@,?,@,?,
?,?,?,?,?,?,?,
@,?,@,*,@,?,@,
?,?,?,?,?,?,?,
?,?,?,?,?,?,?,
?,?,@,@,@,?,?,
?,?,?,?,?,?,?,
@,?,@,?,@,?,@,
?,?,?,*,?,?,?,
?,@,?,?,?,@,?,
?,?,?,?,?,?,?,
?,?,?,?,?,?,?,