!,+,+,+,+,+,+,
Y,O,U,M,U,S,T,
E,@,N,@,E,@,O,
R,O,T,*,?,?,M,
@,W,@,?,@,?,@,
?,R,T,H,Y,O,F,
?,@,?,@,O,@,?,
?,?,?,*,U,R,?,
@,T,@,?,@,?,@,
L,O,X,Y,I,P,K,
?,@,?,@,N,@,?,
?,M,O,R,G,E,S,