+,+,+,!,+,+,+,
?,?,?,?,?,?,?,
@,@,*,?,?,?,?,
?,?,?,?,?,?,?,
?,?,@,@,@,?,?,
?,?,?,*,?,?,?,
?,?,?,?,?,@,@,
?,?,*,?,?,?,?,
?,?,?,?,?,?,?,