!,+,+,+,+,+,
?,?,?,?,?,?,
@,?,@,?,@,?,
?,?,?,*,?,?,
?,@,?,@,?,@,
?,?,?,?,?,?,
@,*,@,?,@,?,
?,?,?,?,?,?,
?,@,?,@,?,@,
?,?,?,?,*,?,
@,?,@,?,@,?,