@,+,!,+,@,
C,L,@,E,F,
G,@,*,@,U,
S,P,E,N,D,
X,P,O,R,N,