-,*,-,#,-,$,-,
?,E,?,?,?,O,?,
?,?,?,?,?,?,?,
?,?,*,#,$,?,?,
?,?,?,?,?,?,?,
?,A,?,I,?,U,?,