S,-,-,?,
E,*,#,A,
W,O,R,K,
S,O,N,G,
N,E,X,T,