@,+,+,!,+,+,@,
C,H,A,T,T,E,R,
R,D,X,E,N,T,E,
?,H,@,@,@,A,?,
?,E,O,I,X,L,K,
?,R,O,M,E,L,E,