!,+,+,+,+,+,+,
C,R,E,A,T,E,+,
E,N,G,L,I,S,H,
W,O,R,D,*,#,$,
H,E,L,P,C,A,T,