W,X,Y,Z,
S,T,U,V,
O,P,Q,R,
M,*,#,N,
I,J,K,L,
E,F,G,H,
A,B,C,D,