-,?,?,?,-,
C,L,#,E,F,
G,*,T,$,U,
S,P,E,N,D,
X,P,O,R,N,