-,-,-,*,-,-,-,
H,E,L,L,O,#,-,
P,L,E,A,S,E,-,
E,N,J,O,Y,$,+,
T,H,E,G,A,M,E,