!,+,+,+,+,
W,X,Y,Z,@,
R,S,T,U,V,
P,*,*,*,Q,
K,L,M,N,O,
F,G,H,I,J,
A,B,C,D,E,