!,+,+,+,+,+,
?,?,?,?,?,?,
?,?,@,?,?,?,
?,?,*,?,?,?,
?,?,?,?,?,?,
?,?,?,?,@,?,
?,?,?,?,*,?,
?,?,?,?,?,?,
?,?,@,?,?,?,
?,?,*,?,?,?,
?,?,?,?,?,?,
?,?,?,?,?,?,